╔══════════════════════════════════════════════════════════════════════════════╗
║                              PHANTOMTHRILL CITY MAP                          ║
╠══════════════════════════════════════════════════════════════════════════════╣
║                                                                              ║
║   ┌─────────────────────── DOWNTOWN ───────────────────────┐                 ║
║   │                                                        │                 ║
║   │      💪 GYM            🚔 POLICE                       │                 ║
║   │        ·                 STATION                       │                 ║
║   │         ·                  ·                           │                 ║
║   │          ·                ·                            │                 ║
║   │           🎷 JAZZ ·······                              │                 ║
║   │              BAR                                       │                 ║
║   └────────────────────────────┬───────────────────────────┘                 ║
║                                │                                             ║
║   ┌─────────── SUBURB ─────────┼──────── CITY CENTRE ──────────────────┐     ║
║   │                            │                                       │     ║
║   │                            │                    🏦 BANK            │     ║
║   │                            │                      ·                │     ║
║   │        🏫 SCHOOL ··········│·····················🏛️ MUSEUM        │     ║
║   │         (Ch.2)             │                    ·    (Ch.1)       │     ║
║   │            ·               │              🍽️ RESTAURANT           │     ║
║   │             ·              │                ·                     │     ║
║   │     🛒 GROCERY ·······🏬 MALL ···············                     │     ║
║   │                            │                                       │     ║
║   └────────────────────────────┼───────────────────────────────────────┘     ║
║                                │                                             ║
║   ┌──────────── OUTSKIRTS ─────┴───────────────────┐                         ║
║   │                                                │                         ║
║   │          🕳️ UNDERGROUND                        │                         ║
║   │              MARKET                            │                         ║
║   │                ·                               │                         ║
║   │          🏥 CLINIC                             │                         ║
║   │              ·                                 │                         ║
║   │          🏨 MOTEL  ← YOU START HERE            │                         ║
║   │                                                │                         ║
║   └────────────────────────────────────────────────┘                         ║
║                                                                              ║
╠══════════════════════════════════════════════════════════════════════════════╣
║  LEGEND:                                                                     ║
║  🏨 Motel - Sleep, Shower           🏬 Mall - Shop, Arcade, Bookstore        ║
║  🏥 Clinic - Meet Cal               🍽️ Restaurant - Eat, Jobs                ║
║  🕳️ Underground - PTA Jobs          🏛️ Museum - JADE WHIP HEIST             ║
║  🛒 Grocery - Buy Food              🏦 Bank - Chapter 5                      ║
║  🏫 School - Chapter 2              🚔 Police - Inspector Mori               ║
║  💪 Gym - Work Out                  🎷 Jazz Bar - Info, Drinks               ║
╚══════════════════════════════════════════════════════════════════════════════╝

CHAPTER 1 PATH:
  Motel → Clinic (meet Cal) → Underground Market (accept job)
       → Museum (scout + meet Inspector) → Underground (start heist)
